Kanton,Bevölkerung 1. Januar,Geburten,Todesfälle,Überschuss,Wanderungssaldo international 1,Wanderungssaldo interkantonal,Bevölkerung 31. Dezember,total,%,Jahr,Canton Size (km²),Abbreviation,Total,Alter 0–19,Alter 20–64,Alter 65 und mehr,Mann,Frau,Schweizer,Ausländer ,Ledig,Verheiratet,Verwitwet,Geschieden,Unverheiratet,In eingetragener Partnerschaft,Aufgelöste Partnerschaft,Städtischer Kernraum,Einflussgebiet Stadt,Ausserhalb des Einflusses städtischer Kerne,BIP in Millionen CHF,BIP Growth Laufende Preise,BIP Growth Preise Vorjahr,BIP pro Kopf
Schweiz,8039060,82731,64961,17770,87106,0,8139631,100571,1.2510293492,2013,41285,CH,8139631,1653511,5053373,1432747,4022091,4117540,6202184,1937447,3537837,3527929,407667,652608,528,12174,888,5106473,1767144,1266014,654611.66897,1.70375,1.79214,80422.76965258007
Zürich,1408575,15996,10792,5204,13623,-1491,1425538,16963,1.2042667235,2013,1729,ZH,1425538,279106,907597,238835,706789,718749,1064112,361426,640145,596614,63246,121378,92,3783,280,1096851,318974,9713,141721.61363,1.13121,2.14208,99416.22996370493
Bern,992617,9587,9527,60,8642,978,1001281,8664,0.8728442088,2013,5959,BE,1001281,192610,611526,197145,489514,511767,855740,145541,426436,436090,57009,80308,55,1265,118,522456,221797,257028,77331.58119,1.74749,1.5534,77232.6461702559
Luzern,386082,4065,2879,1186,2794,348,390349,4267,1.1052056299,2013,1493,LU,390349,82017,243575,64757,193382,196967,323029,67320,177622,168749,18645,24898,20,395,20,207016,43066,140267,25484.10177,2.92177,2.94847,65285.42860363419
Uri,35693,325,341,-16,265,-72,35865,172,0.4818872048,2013,1077,UR,35865,7465,21624,6776,18325,17540,31887,3978,15352,16788,2049,1649,5,19,3,21536,10070,4259,1863.60522,3.58103,3.13899,51961.66792137181
Schwyz,149830,1542,1094,448,902,326,151396,1566,1.0451845425,2013,908,SZ,151396,31108,95980,24308,77456,73940,121710,29686,65808,67671,6795,10960,6,150,6,91887,31910,27599,8892.66258,2.85007,2.60567,58737.76440592882
Obwalden,36115,340,279,61,290,82,36507,392,1.08542157,2013,491,OW,36507,7674,22791,6042,18508,17999,31414,5093,16255,16290,1778,2162,0,21,1,10084,0,26423,2374.13494,-0.84467,-1.36642,65032.32092475416
Nidwalden,41584,392,307,85,322,-67,41888,304,0.731050404,2013,276,NW,41888,7976,26377,7535,21405,20483,36410,5478,18148,18801,1915,3000,4,20,0,15687,5578,20623,2883.26636,5.08261,3.83844,68832.75305576777
Glarus,39369,392,342,50,370,-147,39593,224,0.5689755899,2013,685,GL,39593,7799,24514,7280,20061,19532,30795,8798,16391,17897,2375,2896,2,30,2,29757,0,9836,2680.91856,4.07603,3.99107,67711.9329174349
Zug,116575,1258,764,494,1221,-53,118118,1543,1.323611409,2013,239,ZG,118118,24199,75075,18844,59595,58523,87575,30543,51498,53105,4681,8646,9,172,7,108139,9979,0,18924.06281,5.12783,3.97727,160213.20044362417
Freiburg,291395,3166,1965,1201,3527,1612,297622,6227,2.1369618559,2013,1672,FR,297622,69260,184880,43482,148685,148937,235799,61823,133429,128639,13391,21805,28,307,23,96968,123462,77192,17652.88442,4.93399,4.61936,59313.10326521561
Solothurn,259283,2373,2286,87,1868,676,261437,2154,0.8307524982,2013,791,SO,261437,50993,161991,48453,129750,131687,208257,53180,107676,117278,14447,21718,17,284,17,157750,67642,36045,17296.25571,1.67494,1.4259,66158.40799121777
Basel-Stadt,187425,1894,2049,-155,3246,-1563,189335,1910,1.0190742964,2013,37,BS,189335,31437,119089,38809,91124,98211,124478,64857,86521,72554,11374,18293,26,518,49,189335,0,0,31234.56476,1.17834,2.06517,164969.8405471783
Basel-Landschaft,276537,2380,2384,-4,1744,604,278656,2119,0.7662627424,2013,518,BL,278656,54044,166891,57721,136280,142376,221006,57650,110415,130095,15488,22177,8,449,24,189594,82024,7038,19331.3215,1.46384,1.25178,69373.42637517226
Schaffhausen,77955,734,731,3,966,139,78783,828,1.0621512411,2013,298,SH,78783,15014,47968,15801,38849,39934,59350,19433,31847,35611,4672,6533,2,115,3,45975,24769,8039,6869.04239,2.10399,2.34458,87189.39860122108
Appenzell A.Rh.,53438,498,514,-16,321,10,53691,253,0.4734458625,2013,243,AR,53691,11087,32762,9842,27051,26640,45645,8046,22812,23669,2873,4285,1,50,1,15342,25825,12524,3054.05788,3.50414,3.23317,56882.11953586262
Appenzell I.Rh.,15717,180,138,42,75,-45,15778,61,0.3881147802,2013,172,AI,15778,3611,9354,2813,8082,7696,14124,1654,7301,6833,849,790,0,5,0,0,0,15778,945.20532,3.5736,3.05982,59906.53568259602
St.Gallen,487060,5112,3728,1384,4057,-582,491699,4639,0.9524493902,2013,2028,SG,491699,103824,304496,83379,245249,246450,379074,112625,212153,217246,24433,37452,17,372,26,342097,63752,85850,36288.93775,2.66679,2.49852,73803.15548740185
Graubünden,193920,1764,1721,43,2540,-664,194959,1039,0.5357879538,2013,7105,GR,194959,36264,121272,37423,97225,97734,160440,34519,82946,86995,10791,14065,17,136,9,63422,22838,108699,14028.60654,2.69115,2.2544,71956.70135772137
Aargau,627340,6423,4557,1866,4962,2434,636362,9022,1.4381356202,2013,1404,AG,636362,130718,401257,104387,318438,317924,487918,148444,267706,290630,29573,47742,31,646,34,347785,193747,94830,41229.16645,2.28242,1.93227,64788.856735631605
Thurgau,256213,2489,1966,523,2469,1223,260278,4065,1.5865705487,2013,994,TG,260278,54614,163686,41978,130803,129475,199434,60844,110302,116313,12327,21042,9,265,20,121367,53746,85165,15945.20579,2.54184,2.00216,61262.21113578558
Tessin,341652,2842,3057,-215,5397,-198,346539,4887,1.4304028661,2013,2812,TI,346539,64664,208185,73690,168446,178093,252173,94366,142516,154454,21335,27890,30,280,34,241796,76703,28040,29063.33517,3.629,3.51144,83867.4295533836
Waadt,734356,8274,5410,2864,12244,-1104,749373,15017,2.044920992,2013,3212,VD,749373,167283,461284,120806,366766,382607,503493,245880,336758,314154,34782,62238,44,1306,91,467322,204856,77195,52299.55179,-2.35176,-2.78523,69791.0810637693
Wallis,321732,3142,2629,513,4669,467,327011,5279,1.6408066341,2013,5224,VS,327011,66744,201026,59241,161991,165020,254273,72738,137702,146860,17922,24212,31,269,15,168248,76856,81907,17516.49364,0.97372,1.16555,53565.45694181541
Neuenburg,174554,1716,1580,136,2754,-772,176402,1848,1.0586981679,2013,802,NE,176402,38283,105878,32241,86014,90388,132428,43974,75537,73480,10073,17121,10,173,8,104015,54158,18229,14896.88845,1.88995,1.90198,84448.52354281697
Genf,463101,5167,3322,1845,9701,-2129,469433,6332,1.3673043245,2013,282,GE,469433,99796,292269,77368,226947,242486,279635,189798,214221,189710,20313,43956,59,1083,91,427652,41781,0,50196.61483,1.61907,1.66523,106930.3070512725
Jura,70942,680,599,81,688,14,71738,796,1.1220433594,2013,838,JU,71738,15921,42026,13791,35356,36382,61985,9753,30340,31403,4531,5392,5,61,6,24392,13611,33735,4607.58952,4.70849,4.44096,64228.01750815468
Schweiz,8139631,85287,63938,21349,76223,0,8237666,98035,1.2044157776,2014,41285,CH,8237666,1663752,5108349,1465565,4073880,4163786,6239207,1998459,3593986,3551926,407583,669047,549,13282,1132,5168376,1790738,1278552,665618.37447,1.68141,2.34988,80801.81625110802
Zürich,1425538,16884,10521,6363,14228,675,1446354,20816,1.4602206325,2014,1729,ZH,1446354,283522,919491,243341,717702,728652,1073065,373289,653715,601366,63180,123533,87,4065,376,1113403,323184,9767,144486.87809,1.95119,3.34443,99897.3128915881
Bern,1001281,9731,9111,620,7043,710,1009418,8137,0.8126589838,2014,5959,BE,1009418,193024,615175,201219,494008,515410,857915,151503,431220,437492,56698,82380,56,1408,143,527253,223515,258650,78705.81482,1.77707,1.9524,77971.47942675879
Luzern,390349,4153,2900,1253,2734,115,394604,4255,1.0900501859,2014,1493,LU,394604,82193,246105,66306,195965,198639,325336,69268,179461,170366,18560,25734,23,426,27,208796,43606,142202,26004.33257,2.04139,2.21284,65899.81999675624
Uri,35865,324,320,4,250,-108,36008,143,0.3987174125,2014,1077,UR,36008,7432,21672,6904,18399,17609,31864,4144,15352,16874,2034,1709,7,26,3,21744,9996,4268,1873.05108,0.50686,0.26233,52017.63719173517
Schwyz,151396,1545,1068,477,565,301,152759,1363,0.9002879865,2014,908,SZ,152759,30943,96701,25115,78152,74607,122299,30460,66306,68053,6899,11326,7,159,7,92786,32230,27743,9017.99038,1.40934,1.56231,59034.10195143985
Obwalden,36507,395,255,140,229,-51,36834,327,0.8957186293,2014,491,OW,36834,7697,22853,6284,18693,18141,31609,5225,16330,16465,1777,2236,0,24,1,10232,0,26602,2383.1599,0.38014,0.30816,64700.00271488299
Nidwalden,41888,377,300,77,269,-113,42080,192,0.4583651642,2014,276,NW,42080,7859,26407,7814,21481,20599,36363,5717,18201,18825,1935,3097,4,18,0,15669,5611,20800,2965.14912,2.83993,2.58336,70464.57034220532
Glarus,39593,378,372,6,336,-75,39794,201,0.5076654964,2014,685,GL,39794,7739,24572,7483,20136,19658,30798,8996,16483,17954,2346,2969,3,37,2,30033,0,9761,2719.52508,1.44005,1.72398,68340.07840377947
Zug,118118,1284,742,542,943,467,120089,1971,1.6686703127,2014,239,ZG,120089,24419,76225,19445,60633,59456,88446,31643,52446,53871,4724,8845,9,185,9,110085,10004,0,18298.46872,-3.30581,0.96589,152374.22844723496
Freiburg,297622,3369,2009,1360,2774,1571,303377,5755,1.9336608181,2014,1672,FR,303377,69985,188624,44768,151587,151790,238449,64928,136627,130250,13394,22706,29,331,32,99070,125468,78839,18139.40988,2.75607,3.20252,59791.644982974976
Solothurn,261437,2418,2333,85,1825,403,263719,2282,0.8728680332,2014,791,SO,263719,50998,163222,49499,131036,132683,208749,54970,108942,117721,14420,22280,17,317,20,158965,68210,36544,17571.80308,1.5931,1.8795,66630.78155157572
Basel-Stadt,189335,1996,2138,-142,2609,-1552,190580,1245,0.6575646341,2014,37,BS,190580,31708,120006,38866,91760,98820,124274,66306,88082,72227,11220,18400,26,564,55,190580,0,0,32096.51533,2.7596,4.23831,168414.91935145346
Basel-Landschaft,278656,2534,2366,168,1656,835,281301,2645,0.9491990124,2014,518,BL,281301,54274,168014,59013,137719,143582,221378,59923,111940,130680,15530,22590,8,516,30,191248,82977,7076,19948.28137,3.1915,3.70204,70914.36351097224
Schaffhausen,78783,725,772,-47,643,94,79417,634,0.8047421398,2014,298,SH,79417,15049,48304,16064,39111,40306,59542,19875,32161,35823,4629,6684,1,115,3,46258,25113,8046,6801.57409,-0.98221,0.1607,85643.80535653575
Appenzell A.Rh.,53691,537,478,59,244,103,54064,373,0.6947160604,2014,243,AR,54064,11061,32947,10056,27271,26793,45763,8301,22884,23857,2892,4364,2,63,2,15512,25925,12627,3099.52196,1.48864,2.07507,57330.607428233205
Appenzell I.Rh.,15778,166,131,35,50,18,15854,76,0.4816833566,2014,172,AI,15854,3560,9429,2865,8121,7733,14169,1685,7314,6888,832,811,1,6,2,0,0,15854,985.1826,4.22948,4.85681,62140.94865649047
St.Gallen,491699,5058,3805,1253,4094,-1050,495824,4125,0.8389278807,2014,2028,SG,495824,103606,306925,85293,247516,248308,380500,115324,213956,218680,24388,38323,19,427,27,345076,64295,86453,36885.12328,1.64289,1.55396,74391.5649101294
Graubünden,194959,1803,1704,99,1755,-719,195886,927,0.4754845891,2014,7105,GR,195886,36216,121197,38473,97752,98134,160497,35389,83175,87244,10767,14518,14,157,8,63964,23158,108764,14125.80718,0.69287,0.86576,72112.3877153038
Aargau,636362,6687,4510,2177,4985,1819,645277,8915,1.4009321738,2014,1404,AG,645277,131899,406026,107352,323221,322056,491344,153933,271914,293481,29812,49241,29,741,47,352263,196965,96049,41857.04587,1.5229,1.58466,64866.78724020847
Thurgau,260278,2664,1958,706,2212,608,263733,3455,1.3274268282,2014,994,TG,263733,54703,165714,43316,132602,131131,200849,62884,111665,117791,12339,21627,10,275,25,122659,54520,86554,16185.60854,1.50768,1.97114,61371.19184933247
Tessin,346539,2908,2924,-16,4227,-607,350363,3824,1.103483302,2014,2812,TI,350363,64890,209924,75549,170541,179822,253633,96730,144627,155370,21411,28566,34,316,37,244556,77714,28093,29652.67872,2.02779,2.33627,84634.16148394665
Waadt,749373,8387,5275,3112,8210,-1409,761446,12073,1.6110801964,2014,3212,VD,761446,168899,468935,123612,373187,388259,509124,252322,344572,316709,34765,63790,50,1408,126,473240,209112,79094,53909.83693,3.07897,3.1164,70799.29099371459
Wallis,327011,3198,2501,697,3639,614,331763,4752,1.453162126,2014,5224,VS,331763,67069,203445,61249,164399,167364,256485,75278,140038,148109,18051,25211,37,281,22,170951,78286,82526,17655.22555,0.79201,0.56499,53216.379011523284
Neuenburg,176402,1803,1626,177,1758,-889,177327,925,0.524370472,2014,802,NE,177327,38257,106437,32633,86540,90787,132575,44752,76527,73138,9985,17490,10,166,11,104447,54655,18225,15186.94772,1.94711,2.75042,85643.74133662668
Genf,469433,5282,3159,2123,9650,-1861,477385,7952,1.6939584563,2014,282,GE,477385,100889,297676,78820,230606,246779,281897,195488,219302,191276,20439,45003,61,1186,111,434887,42498,0,50311.47867,0.22883,0.82824,105389.73505661049
Jura,71738,681,660,21,553,123,72410,672,0.9367420335,2014,838,JU,72410,15861,42323,14226,35742,36668,62284,10126,30746,31416,4556,5614,5,65,6,24699,13696,34015,4751.96395,3.1334,3.86145,65625.79685126364
Schweiz,8237666,86559,67606,18953,71884,0,8327126,89460,1.0859872202,2015,41285,CH,8327126,1675503,5156571,1495052,4121471,4205655,6278459,2048667,3650651,3568702,407151,684114,563,14306,1446,5224160,1812583,1290383,668006.3817,0.35877,1.64463,80220.52046528418
Zürich,1446354,16866,11156,5710,14367,1590,1466424,20070,1.3876270954,2015,1729,ZH,1466424,287660,931178,247586,728517,737907,1083372,383052,666873,606119,63094,125457,82,4277,473,1129596,326788,10040,144642.66345,0.10782,2.42186,98636.31763391761
Bern,1009418,10072,9644,428,6824,856,1017483,8065,0.7989752511,2015,5959,BE,1017483,194111,618383,204989,498258,519225,860017,157466,437186,437850,56477,84190,55,1522,177,531765,225656,260062,78524.05539,-0.23094,0.17529,77174.808217926
Luzern,394604,4192,3137,1055,2717,174,398762,4158,1.0537146101,2015,1493,LU,398762,82391,248701,67670,198192,200570,327503,71259,181455,171654,18613,26480,28,490,34,210096,44133,144533,26331.17943,1.25689,1.9901,66032.3186010703
Uri,36008,322,367,-45,153,-121,35973,-35,-0.097200622,2015,1077,UR,35973,7385,21576,7012,18348,17625,31840,4133,15323,16844,2027,1742,7,27,3,21833,9901,4239,1884.67324,0.62049,-0.59608,52391.327940399744
Schwyz,152759,1607,1164,443,593,229,154093,1334,0.8732709693,2015,908,SZ,154093,30831,97333,25929,78825,75268,122921,31172,66828,68527,6917,11630,7,174,8,93739,32480,27874,9249.8374,2.57094,3.36459,60027.628769639115
Obwalden,36834,359,270,89,212,-65,37076,242,0.6570016832,2015,491,OW,37076,7655,22935,6486,18801,18275,31716,5360,16432,16538,1771,2309,1,24,1,10229,0,26847,2419.2417,1.51403,1.24485,65250.88197216528
Nidwalden,42080,426,304,122,209,13,42420,340,0.8079847909,2015,276,NW,42420,7903,26463,8054,21705,20715,36514,5906,18392,18874,1946,3171,4,31,1,15773,5645,21002,3177.9151,7.17556,8.27838,74915.49033474777
Glarus,39794,409,354,55,397,-124,40028,234,0.588028346,2015,685,GL,40028,7762,24638,7628,20309,19719,30721,9307,16607,17981,2337,3061,3,34,5,30367,0,9661,2736.19469,0.61296,0.91407,68357.0173378635
Zug,120089,1295,735,560,980,434,122134,2045,1.7029036798,2015,239,ZG,122134,24710,77432,19992,61708,60426,89157,32977,53320,54702,4771,9124,12,186,18,111957,10177,0,19243.19179,5.16285,7.32469,157558.0247105638
Freiburg,303377,3391,2049,1342,1747,936,307461,4084,1.3461798357,2015,1672,FR,307461,70214,191105,46142,153729,153732,240182,67279,138940,131243,13395,23452,33,349,40,100331,126895,80235,18257.69489,0.65209,2.2869,59382.14892295283
Solothurn,263719,2536,2500,36,1943,597,266418,2699,1.0234378259,2015,791,SO,266418,51266,164739,50413,132439,133979,209355,57063,110681,118113,14493,22736,15,346,31,160616,68851,36951,17665.54196,0.53346,1.23691,66307.61420024172
Basel-Stadt,190580,2032,2146,-114,2568,-1485,191817,1237,0.6490712562,2015,37,BS,191817,32205,120778,38834,92514,99303,124365,67452,89611,71876,11013,18618,22,605,66,191817,0,0,32764.38987,2.08083,3.93401,170810.66782401977
Basel-Landschaft,281301,2550,2525,25,1474,613,283231,1930,0.6860978098,2015,518,BL,283231,54436,168679,60116,138808,144423,221489,61742,113105,131033,15535,22967,7,547,31,192488,83710,7033,20327.19358,1.89947,3.62318,71768.95742344589
Schaffhausen,79417,700,743,-43,552,-78,79836,419,0.5275948475,2015,298,SH,79836,15032,48401,16403,39391,40445,59664,20172,32404,35863,4637,6810,2,109,10,46264,25529,8043,6756.54773,-0.662,2.73216,84630.33881958014
Appenzell A.Rh.,54064,558,508,50,342,71,54543,479,0.8859869784,2015,243,AR,54543,11103,33196,10244,27506,27037,45985,8558,23055,24037,2874,4493,2,80,2,15721,26110,12712,3127.70844,0.90938,2.59211,57343.9018755844
Appenzell I.Rh.,15854,181,137,44,62,32,15974,120,0.7569067743,2015,172,AI,15974,3536,9514,2924,8196,7778,14240,1734,7338,6962,851,811,1,9,2,0,0,15974,992.23428,0.71577,1.97635,62115.58031801678
St.Gallen,495824,5363,3945,1418,3329,-1666,499065,3241,0.653659363,2015,2028,SG,499065,103693,308228,87144,249392,249673,381712,117353,215628,219430,24353,39106,18,482,34,347036,64874,87155,36676.13352,-0.5666,0.99187,73489.69276547144
Graubünden,195886,1748,1734,14,1666,-657,196610,724,0.3696027281,2015,7105,GR,196610,36141,121035,39434,98212,98398,160689,35921,83298,87457,10723,14935,14,166,13,64034,23551,109025,14011.72557,-0.80761,-1.88696,71266.5966634454
Aargau,645277,6707,4871,1836,5109,1501,653675,8398,1.3014565838,2015,1404,AG,653675,133140,410237,110298,327787,325888,495277,158398,276123,296112,29863,50636,33,828,75,356655,199598,97422,41592.75056,-0.63142,-0.45456,63629.097885034615
Thurgau,263733,2785,1941,844,1827,952,267429,3696,1.4014173425,2015,994,TG,267429,55091,167645,44693,134455,132974,202663,64766,113225,119222,12421,22211,12,308,27,124367,55336,87726,16060.14618,-0.77515,0.56954,60053.8691764917
Tessin,350363,2957,3294,-337,2738,-976,351946,1583,0.4518171154,2015,2812,TI,351946,64923,210292,76731,171466,180480,254288,97658,146039,155145,21417,28923,38,344,38,245345,78562,28039,29622.96882,-0.10019,0.7873,84169.07372153683
Waadt,761446,8385,5599,2786,9767,-1069,773407,11961,1.5708270843,2015,3212,VD,773407,170633,476817,125957,379074,394333,513739,259668,353300,318102,34604,65634,51,1533,159,479658,213338,80411,53575.37049,-0.62042,0.69083,69271.89757786004
Wallis,331763,3247,2726,521,2860,766,335696,3933,1.185484819,2015,5224,VS,335696,67347,205413,62936,166426,169270,258612,77084,142216,148810,18126,26148,33,312,35,173187,79551,82958,18196.04959,3.06325,2.37415,54203.951164148515
Neuenburg,177327,1783,1655,128,1573,-820,178107,780,0.4398653335,2015,802,NE,178107,38117,107066,32924,87021,91086,132556,45551,77637,72597,9888,17781,13,169,20,104592,55172,18343,15463.35493,1.82003,3.16137,86820.59060003256
Genf,477385,5388,3405,1983,8309,-1546,484736,7351,1.5398472931,2015,282,GE,484736,102431,302313,79992,234427,250309,287521,197215,224586,192263,20467,45916,62,1294,137,441772,42964,0,50042.25798,-0.53511,0.97635,103236.1078607737
Jura,72410,700,697,3,506,-136,72782,372,0.513741196,2015,838,JU,72782,15787,42474,14521,35965,36817,62361,10421,31049,31348,4538,5773,8,60,6,24922,13762,34098,4665.36113,-1.82246,-0.86722,64100.479926355416
Schweiz,8327126,87883,64964,22919,71030,0,8419550,92424,1.1099147533,2016,41285,CH,8419550,1691466,5205025,1523059,4173437,4246113,6318404,2101146,3710349,3585129,406983,699200,597,15324,1730,5282707,1837044,1299799,677848.33056,1.47333,2.06869,80508.85505282349
Zürich,1466424,17051,10716,6335,14632,2114,1487969,21545,1.4692203619,2016,1729,ZH,1487969,293045,943505,251419,739814,748155,1092631,395338,681544,610364,63250,127472,93,4623,555,1146031,331802,10136,146281.06094,1.13272,1.7484,98309.21271881336
Bern,1017483,10113,9437,676,7684,748,1026513,9030,0.8874841152,2016,5959,BE,1026513,195733,622339,208441,503789,522724,861614,164899,443834,438530,56089,86136,58,1610,223,537279,228035,261199,78336.78608,-0.23849,0.52077,76313.48660952174
Luzern,398762,4265,2844,1421,3375,-270,403397,4635,1.1623474654,2016,1493,LU,403397,82723,251486,69188,200897,202500,329264,74133,183772,173311,18609,27087,23,539,47,212163,45057,146177,26794.83088,1.76085,2.60975,66422.98004199337
Uri,35973,332,348,-16,253,-41,36145,172,0.4781363801,2016,1077,UR,36145,7377,21652,7116,18427,17718,31850,4295,15449,16834,2001,1818,8,32,2,22132,9815,4198,1895.97625,0.59973,0.61521,52454.73094480564
Schwyz,154093,1559,1133,426,921,331,155863,1770,1.1486569799,2016,908,SZ,155863,30881,98333,26649,79852,76011,123597,32266,67605,69135,6974,11948,5,183,11,94847,32888,28128,9313.17952,0.68479,1.2448,59752.3435324612
Obwalden,37076,370,246,124,237,-28,37378,302,0.8145431007,2016,491,OW,37378,7639,23026,6713,18965,18413,31892,5486,16571,16616,1762,2400,1,27,1,10233,0,27145,2476.0583,2.34853,2.68532,66243.73428219809
Nidwalden,42420,398,296,102,197,-161,42556,136,0.3206034889,2016,276,NW,42556,7863,26417,8276,21795,20761,36521,6035,18386,18915,1978,3233,4,35,3,15891,5682,20983,3064.19211,-3.57854,-3.2442,72003.76233668577
Glarus,40028,414,370,44,257,-135,40147,119,0.2972918957,2016,685,GL,40147,7773,24584,7790,20329,19818,30650,9497,16683,17945,2329,3148,2,36,4,30572,0,9575,2718.89978,-0.63208,-0.1077,67723.61023239595
Zug,122134,1377,746,631,1016,98,123948,1814,1.4852539015,2016,239,ZG,123948,25113,78376,20459,62684,61264,89809,34139,54199,55359,4796,9359,12,206,15,113636,10312,0,19574.98598,1.72422,2.23905,157929.01845935392
Freiburg,307461,3501,2022,1479,1899,1187,311914,4453,1.4483137699,2016,1672,FR,311914,70816,193603,47495,156334,155580,242087,69827,141835,131932,13448,24230,34,385,43,103226,128666,80022,18289.33394,0.17329,0.99991,58635.822502356415
Solothurn,266418,2591,2268,323,2249,568,269441,3023,1.134683092,2016,791,SO,269441,51712,166200,51529,134300,135141,210240,59201,112377,118905,14383,23344,15,368,40,162403,69702,37336,17665.91637,0.00212,0.4221,65565.06385442453
Basel-Stadt,191817,2076,1988,88,2887,-1718,193070,1253,0.6532267734,2016,37,BS,193070,32634,121641,38795,93212,99858,124026,69044,91119,71579,10856,18773,20,652,66,193070,0,0,35204.04437,7.44606,8.65222,182338.2419329777
Basel-Landschaft,283231,2608,2432,176,1379,834,285624,2393,0.8448933909,2016,518,BL,285624,54894,169564,61166,140142,145482,221990,63634,114577,131232,15659,23510,10,589,44,194396,84267,6961,20435.72932,0.53394,1.04119,71547.66168109122
Schaffhausen,79836,758,748,10,784,114,80769,933,1.1686457237,2016,298,SH,80769,15243,48813,16713,40020,40749,59889,20880,32985,36035,4616,6996,2,125,9,46555,25971,8243,6827.35345,1.04796,2.55092,84529.3794648937
Appenzell A.Rh.,54543,586,506,80,329,-46,54954,411,0.753533909,2016,243,AR,54954,11145,33434,10375,27778,27176,46044,8910,23260,24154,2851,4604,2,80,3,15730,26328,12896,3147.8499,0.64397,1.31821,57281.54274484114
Appenzell I.Rh.,15974,186,155,31,76,-8,16003,29,0.1815450106,2016,172,AI,16003,3511,9527,2965,8237,7766,14230,1773,7311,6974,851,853,1,11,2,0,0,16003,1008.6843,1.65788,2.30171,63030.95044679123
St.Gallen,499065,5388,3845,1543,3742,-1948,502552,3487,0.6987065813,2016,2028,SG,502552,104274,309354,88924,251526,251026,382829,119723,217268,220661,24299,39721,22,519,44,348830,65680,88042,37105.30738,1.17017,1.91237,73833.76721214919
Graubünden,196610,1806,1624,182,1669,-671,197550,940,0.4781038604,2016,7105,GR,197550,36079,121002,40469,98853,98697,160932,36618,83644,87645,10710,15346,13,169,18,64339,24115,109096,14100.51146,0.63365,0.82619,71376.92462667679
Aargau,653675,6979,4761,2218,5435,2036,663462,9787,1.4972272154,2016,1404,AG,663462,134820,415503,113139,333364,330098,499712,163750,281253,299038,30097,52051,36,877,100,361839,202751,98872,42131.70882,1.2958,1.4818,63502.82129195041
Thurgau,267429,2866,1968,898,1764,590,270709,3280,1.226493761,2016,994,TG,270709,55450,169396,45863,136199,134510,204378,66331,114727,120577,12401,22625,11,333,32,125473,56391,88845,16406.11052,2.15418,2.80686,60604.230077315486
Tessin,351946,2806,2988,-182,3230,-798,354375,2429,0.6901626954,2016,2812,TI,354375,65054,211291,78030,172877,181498,254828,99547,147721,155287,21432,29477,39,375,42,246930,79034,28411,29563.90365,-0.19939,0.31081,83425.47767195768
Waadt,773407,8730,5413,3317,8896,-910,784822,11415,1.4759369905,2016,3212,VD,784822,172689,483842,128291,385389,399433,520957,263865,361457,319592,34549,67313,59,1639,183,486030,216920,81872,57009.94537,6.41073,6.95957,72640.60560228943
Wallis,335696,3274,2612,662,2388,650,339176,3480,1.0366522091,2016,5224,VS,339176,67739,206913,64524,168072,171104,260444,78732,144112,149235,18259,27145,37,325,48,175361,80642,83173,18301.80897,0.58122,0.90067,53959.62264429087
Neuenburg,178107,1804,1571,233,1209,-892,178567,460,0.2582717131,2016,802,NE,178567,38110,107176,33281,87312,91255,132878,45689,78415,71940,9830,18152,13,191,26,104666,55652,18249,15173.90412,-1.87185,-1.28352,84975.9704760678
Genf,484736,5361,3220,2141,5200,-1669,489524,4788,0.987754159,2016,282,GE,489524,103456,305371,80697,237112,252412,292641,196883,228827,192187,20410,46530,70,1328,161,446042,43482,0,50364.83604,0.64461,0.90709,102885.32541816132
Jura,72782,684,707,-23,194,36,73122,340,0.4671484708,2016,838,JU,73122,15693,42677,14752,36158,36964,62471,10651,31418,31147,4544,5929,7,67,8,25033,13852,34237,4655.41274,-0.21324,0.28068,63666.37591969585
Schweiz,8419550,87381,66971,20410,45948,0,8484130,64580,0.7670243659,2017,41285,CH,8484130,1700494,5233271,1550365,4206434,4277696,6357738,2126392,3755372,3592368,406117,711025,588,16435,2001,5339043,1852223,1292864,684558.46748,0.98992,1.3628,80686.93755046187
Zürich,1487969,17070,11076,5994,10360,1567,1504346,16377,1.1006277685,2017,1729,ZH,1504346,296854,952121,255371,748276,756070,1102014,402332,693245,613343,62962,129082,90,4914,655,1158518,335631,10197,148710.70989,1.66095,2.44974,98854.06009654693
Bern,1026513,10141,9465,676,4102,362,1031126,4613,0.4493854437,2017,5959,BE,1031126,196464,622668,211994,505911,525215,864345,166781,447669,437969,55951,87498,57,1696,258,540715,228540,261871,78903.20877,0.72306,0.88863,76521.40356270717
Luzern,403397,4384,3077,1307,1676,-169,406506,3109,0.7707047896,2017,1493,LU,406506,82868,252896,70742,202534,203972,331512,74994,185365,174163,18682,27623,23,591,51,213163,45846,147497,27243.27993,1.67364,2.35084,67018.1496214078
Uri,36145,350,359,-9,189,-13,36299,154,0.4260616959,2017,1077,UR,36299,7359,21656,7284,18522,17777,31928,4371,15541,16869,1991,1855,7,31,5,22323,9795,4181,1932.22382,1.91182,3.04284,53230.772748560565
Schwyz,155863,1510,1067,443,729,221,157301,1438,0.9226051083,2017,908,SZ,157301,30745,99111,27445,80618,76683,124130,33171,68164,69693,6999,12216,5,207,14,95518,33446,28337,9514.90326,2.166,2.41246,60488.51094398637
Obwalden,37378,377,279,98,141,-44,37575,197,0.5270479961,2017,491,OW,37575,7622,23079,6874,19030,18545,32056,5519,16589,16719,1770,2462,1,33,1,10236,0,27339,2495.06168,0.76749,1.65243,66402.17378576181
Nidwalden,42556,418,334,84,195,125,42969,413,0.9704859479,2017,276,NW,42969,7868,26620,8481,22006,20963,36712,6257,18592,19055,1979,3293,4,41,3,16038,5715,21216,3026.83834,-1.21904,-0.82387,70442.37333891875
Glarus,40147,378,378,0,235,-52,40349,202,0.5031509204,2017,685,GL,40349,7761,24631,7957,20423,19926,30636,9713,16800,17940,2318,3243,2,40,6,30768,0,9581,2828.80873,4.04241,3.98023,70108.5214007782
Zug,123948,1257,795,462,844,91,125421,1473,1.1884015878,2017,239,ZG,125421,25369,79087,20965,63410,62011,90430,34991,54968,55876,4848,9471,13,225,18,115060,10361,0,19100.19345,-2.42551,-2.49419,152288.639462291
Freiburg,311914,3428,2061,1367,715,1205,315074,3160,1.0130997647,2017,1672,FR,315074,70790,195404,48880,157874,157200,244143,70931,143931,132264,13480,24910,30,408,43,103666,132449,78959,18627.22945,1.8475,1.98606,59120.173197407596
Solothurn,269441,2555,2444,111,1713,175,271432,1991,0.7389372813,2017,791,SO,271432,51786,167169,52477,135497,135935,210812,60620,113401,119540,14256,23766,13,398,44,163697,70005,37730,17888.23339,1.25845,1.66003,65903.18529134369
Basel-Stadt,193070,2069,2123,-54,2167,-1308,193908,838,0.4340394676,2017,37,BS,193908,33117,122052,38739,93723,100185,124147,69761,92283,71463,10613,18774,23,682,66,193908,0,0,36876.2111,4.74993,5.73085,190173.7478598098
Basel-Landschaft,285624,2694,2462,232,609,702,287023,1399,0.4898047783,2017,518,BL,287023,55109,169687,62227,140771,146252,222343,64680,115488,131317,15650,23879,10,624,53,195457,84629,6937,20728.94502,1.43482,0.88488,72220.50156259254
Schaffhausen,80769,747,739,8,480,161,81351,582,0.7205734874,2017,298,SH,81351,15302,48973,17076,40251,41100,60185,21166,33340,36151,4598,7111,2,138,11,46786,26260,8305,6913.34758,1.25955,3.16637,84981.71602070042
Appenzell A.Rh.,54954,564,506,58,87,51,55178,224,0.4076136405,2017,243,AR,55178,11150,33438,10590,27879,27299,46181,8997,23452,24134,2844,4661,2,78,7,15780,26482,12916,3112.6167,-1.11928,-0.63995,56410.46612780456
Appenzell I.Rh.,16003,186,121,65,67,-43,16105,102,0.6373804912,2017,172,AI,16105,3479,9613,3013,8290,7815,14271,1834,7319,7029,855,887,1,10,3,0,0,16105,1002.78446,-0.58491,-0.33024,62265.41198385594
St.Gallen,502552,5205,3886,1319,2562,-1885,504686,2134,0.4246326748,2017,2028,SG,504686,104151,309810,90725,252710,251976,383755,120931,218391,220999,24270,40353,25,583,46,349971,66182,88533,37438.98271,0.89927,1.43482,74182.72492203073
Graubünden,197550,1712,1746,-34,1055,-637,197888,338,0.1710959251,2017,7105,GR,197888,35900,120638,41350,99050,98838,160985,36903,83843,87490,10729,15615,12,177,17,64286,24278,109324,14131.66518,0.22094,0.56712,71412.44127991592
Aargau,663462,6914,4711,2203,3435,2175,670988,7526,1.1343528341,2017,1404,AG,670988,135945,418619,116424,337178,333810,503709,167279,285025,301472,30228,53141,31,955,123,366041,204615,100332,42758.50104,1.4877,1.36276,63724.68813153142
Thurgau,270709,2809,1986,823,1258,970,273801,3092,1.1421858896,2017,994,TG,273801,55725,170831,47245,137823,135978,206118,67683,115956,121914,12416,23119,10,348,35,126811,56985,90005,16540.74113,0.82061,1.31244,60411.543895018636
Tessin,354375,2774,3230,-456,511,-743,353709,-666,-0.187936508,2017,2812,TI,353709,64769,210041,78899,172505,181204,255122,98587,148100,153870,21396,29849,41,408,43,251864,76000,25845,29284.94673,-0.94357,-0.66622,82793.89761074782
Waadt,784822,8686,5749,2937,6218,-1108,793129,8307,1.0584565672,2017,3212,VD,793129,174446,488905,129778,389504,403625,527117,266012,368315,319792,34382,68554,57,1786,216,491022,219482,82625,55195.67504,-3.18238,-3.29394,69592.3047070527
Wallis,339176,3259,2759,500,1161,929,341463,2287,0.6742811991,2017,5224,VS,341463,67825,207639,65999,169162,172301,263082,78381,145510,149095,18326,28051,35,378,52,187341,81289,72833,18535.8271,1.27866,1.95278,54283.559565750904
Neuenburg,178567,1758,1612,146,406,-989,177964,-603,-0.337688375,2017,802,NE,177964,37939,106567,33458,87093,90871,132811,45153,78725,71046,9692,18242,14,212,32,103991,56005,17968,15552.72609,2.49654,3.51973,87392.54057000292
Genf,489524,5441,3342,2099,5910,-1727,495249,5725,1.169503436,2017,282,GE,495249,104604,309359,81286,240114,255135,296675,198574,233719,192268,20355,47242,71,1394,190,451065,44184,0,51443.49671,2.14169,1.9723,103874.00420798427
Jura,73122,695,664,31,186,-16,73290,168,0.2297530155,2017,838,JU,73290,15547,42657,15086,36280,37010,62519,10771,31641,30897,4527,6128,9,78,9,25018,14044,34228,4771.31017,2.48952,3.23982,65101.78973939146
Schweiz,8484130,87851,67088,20763,39860,0,8544527,60397,0.7118820669,2018,41285,CH,8544527,1709458,5257768,1577301,4237121,4307406,6396252,2148275,3797529,3597800,405348,723331,598,17392,2305,5380353,1861193,1302981,709521.5565,3.6466,2.86045,83038.13148463338
Zürich,1504346,16919,11062,5857,10761,1808,1520968,16622,1.1049319771,2018,1729,ZH,1520968,300178,962059,258731,757081,763887,1112574,408394,705128,616619,62676,130518,90,5125,753,1173534,337221,10213,156883.07738,5.49548,4.25714,103146.86264273805
Bern,1031126,10145,9451,694,3403,57,1034977,3851,0.3734752106,2018,5959,BE,1034977,197081,622412,215484,507791,527186,865906,169071,450924,437708,55506,88678,55,1787,296,543353,229573,262051,80775.78955,2.37326,1.53582,78045.97546612147
Luzern,406506,4413,3140,1273,1777,-190,409557,3051,0.7505424274,2018,1493,LU,409557,83363,254126,72068,204100,205457,333672,75885,187057,174800,18649,28311,24,651,58,214883,46250,148424,27792.86656,2.01733,0.79854,67860.802183823
Uri,36299,356,324,32,140,-58,36433,134,0.3691561751,2018,1077,UR,36433,7340,21651,7442,18609,17824,31936,4497,15568,16939,1996,1886,8,31,5,22499,9789,4145,1962.56,1.57001,2.04065,53867.64746246535
Schwyz,157301,1628,1152,476,787,535,159165,1864,1.1849892881,2018,908,SZ,159165,30986,99947,28232,81599,77566,124828,34337,68977,70322,7053,12543,5,238,23,96821,33747,28597,9720.14955,2.1571,1.62959,61069.64188106682
Obwalden,37575,384,258,126,137,14,37841,266,0.7079174983,2018,491,OW,37841,7639,23100,7102,19144,18697,32296,5545,16644,16880,1782,2494,2,37,2,10368,0,27473,2520.40292,1.01566,1.1629,66605.08231812056
Nidwalden,42969,432,301,131,131,-25,43223,254,0.5911238335,2018,276,NW,43223,7884,26552,8787,22122,21101,36872,6351,18622,19151,1999,3402,4,42,1,16097,5777,21349,3064.67828,1.25015,-0.02631,70903.8771024686
Glarus,40349,407,363,44,97,-66,40403,54,0.1338323131,2018,685,GL,40403,7726,24566,8111,20448,19955,30671,9732,16842,17889,2310,3316,2,41,3,30909,0,9494,2790.11952,-1.36769,-1.72128,69057.23634383586
Zug,125421,1343,814,529,802,48,126837,1416,1.1289975363,2018,239,ZG,126837,25729,79597,21511,64195,62642,90917,35920,55454,56502,4903,9693,12,248,22,116378,10459,0,19674.41877,3.00638,2.07381,155115.7688214007
Freiburg,315074,3546,2058,1488,600,1536,318714,3640,1.1552841555,2018,1672,FR,318714,71206,197382,50126,159579,159135,246355,72359,146131,132836,13533,25678,25,444,58,104670,133895,80149,19066.30713,2.35718,1.72512,59822.621943184175
Solothurn,271432,2659,2464,195,1134,334,273194,1762,0.649149695,2018,791,SO,273194,52055,167704,53435,136475,136719,211399,61795,114497,119734,14210,24262,11,412,61,164793,70080,38321,18369.42889,2.69001,2.15227,67239.50339319311
Basel-Stadt,193908,2075,2077,-2,2420,-1525,194766,858,0.4424778761,2018,37,BS,194766,33585,122466,38715,94311,100455,123867,70899,93443,71195,10436,18868,25,722,74,194766,0,0,38110.19693,3.34629,2.60548,195671.71338940063
Basel-Landschaft,287023,2623,2446,177,626,314,288132,1109,0.3863801856,2018,518,BL,288132,55328,169597,63207,141341,146791,222396,65736,116257,131140,15671,24333,9,661,59,196108,85166,6858,20819.445,0.43659,-0.54491,72256.62196493274
Schaffhausen,81351,772,774,-2,469,168,81991,640,0.7867143612,2018,298,SH,81991,15411,49233,17347,40560,41431,60626,21365,33668,36412,4568,7186,1,141,15,47099,26527,8365,7172.36945,3.74669,3.88541,87477.52131331488
Appenzell A.Rh.,55178,592,459,133,123,-199,55234,56,0.1014897242,2018,243,AR,55234,11128,33220,10886,27889,27345,46220,9014,23502,24128,2795,4720,1,81,7,15745,26569,12920,3201.04029,2.84081,2.60951,57954.16392077343
Appenzell I.Rh.,16105,169,137,32,61,-53,16145,40,0.2483700714,2018,172,AI,16145,3424,9630,3091,8300,7845,14321,1824,7354,6995,847,930,1,15,3,0,0,16145,1034.1429,3.12714,2.76971,64053.446887581296
St.Gallen,504686,5368,3880,1488,2384,-924,507697,3011,0.5966085843,2018,2028,SG,507697,104248,310799,92650,254304,253393,385295,122402,219865,221801,24302,41014,28,605,54,351835,66645,89217,38071.56852,1.68964,1.99526,74988.76006752059
Graubünden,197888,1794,1789,5,731,-217,198379,491,0.2481201488,2018,7105,GR,198379,35687,120386,42306,99374,99005,161397,36982,84164,87286,10743,15942,15,202,24,64561,24381,109437,14501.14771,2.61457,2.43522,73098.19945659571
Aargau,670988,6945,4780,2165,3435,1875,678207,7219,1.0758761707,2018,1404,AG,678207,137245,421254,119708,340776,337431,507783,170424,288490,303630,30375,54508,34,1025,128,370533,206174,101500,43687.13571,2.17181,1.40039,64415.6366861445
Thurgau,273801,2971,2067,904,1235,596,276472,2671,0.9755260207,2018,994,TG,276472,56175,171646,48651,139185,137287,207714,68758,117130,122858,12492,23572,12,366,40,127977,57457,91038,16991.91157,2.72763,2.16634,61459.79184148847
Tessin,353709,2556,3152,-596,884,-731,353343,-366,-0.10347489,2018,2812,TI,353343,64098,209350,79895,172192,181151,255116,98227,148532,152586,21400,30299,41,431,52,251554,76225,25564,30521.09186,4.22109,3.52512,86378.08548634047
Waadt,793129,8736,5750,2986,4327,-1437,799145,6016,0.7585146931,2018,3212,VD,799145,175670,492075,131400,392529,406616,533878,265267,374074,319150,34214,69485,60,1892,247,493915,222272,82958,58384.07719,5.77654,5.00867,73058.17741461187
Wallis,341463,3326,2724,602,907,1316,343955,2492,0.7298008862,2018,5224,VS,343955,68005,208500,67450,170431,173524,265879,78076,147060,149070,18370,28941,33,408,56,188756,82257,72942,19308.02935,4.166,3.66795,56135.33558168946
Neuenburg,177964,1656,1601,55,244,-1217,176850,-1114,-0.625969297,2018,802,NE,176850,37361,105812,33677,86621,90229,132143,44707,78853,69688,9652,18382,12,228,34,103062,52257,21531,16199.71183,4.15995,4.56945,91601.42397512015
Genf,495249,5353,3385,1968,4953,-1978,499480,4231,0.854317727,2018,282,GE,499480,105511,312012,81957,241848,257632,299540,199940,237453,191859,20326,48059,78,1475,219,455141,44339,0,53899.99455,4.77514,3.58081,107912.21780651878
Jura,73290,683,680,3,185,19,73419,129,0.1760130986,2018,838,JU,73419,15395,42692,15332,36317,37102,62651,10768,31840,30622,4540,6311,10,84,11,24996,14133,34290,4999.89508,4.79082,5.06185,68100.8332992822
Schweiz,8544527,86172,67780,18392,43352,0,8606033,61506,0.7198291959,2019,41285,CH,8606033,1717198,5283035,1605800,4268863,4337170,6430658,2175375,3843439,3599225,404591,737094,596,18231,2606,5422227,1874960,1308846,716878.58983,1.0369,1.14198,83299.53996574263
Zürich,1520968,16587,11305,5282,12760,1815,1539275,18307,1.2036413652,2019,1729,ZH,1539275,304095,972784,262396,766679,772596,1122495,416780,718884,619082,62535,132491,85,5304,839,1190339,338757,10179,155290.74181,-1.01498,-0.63796,100885.63889493431
Bern,1034977,9933,9667,266,3991,76,1039474,4497,0.4345024092,2019,5959,BE,1039474,197741,622788,218945,510170,529304,867188,172286,455044,436650,55218,90309,50,1869,313,546207,230693,262574,82365.69844,1.9683,1.62612,79237.86303457325
Luzern,409557,4357,3104,1253,1772,319,413120,3563,0.8699643761,2019,1493,LU,413120,83814,255571,73735,205976,207144,335508,77612,188877,175800,18629,29020,24,682,76,217191,46639,149290,28304.31765,1.84022,2.61069,68513.54969500388
Uri,36433,342,307,35,145,51,36703,270,0.7410863777,2019,1077,UR,36703,7357,21715,7631,18739,17964,32084,4619,15739,16983,1982,1955,6,33,5,22656,9859,4188,2000.81065,1.94902,1.52833,54513.54521428766
Schwyz,159165,1536,1107,429,556,303,160480,1315,0.8261866616,2019,908,SZ,160480,30944,100405,29131,82213,78267,125367,35113,69530,70689,7055,12907,6,257,32,97586,34089,28805,9954.6804,2.41283,2.14052,62030.66051844467
Obwalden,37841,347,279,68,95,-74,37930,89,0.2351946302,2019,491,OW,37930,7590,23018,7322,19158,18772,32361,5569,16648,16906,1803,2529,2,39,2,10458,0,27472,2630.1019,4.35244,3.34876,69340.94120748747
Nidwalden,43223,384,336,48,135,-334,43087,-136,-0.314647294,2019,276,NW,43087,7798,26281,9008,22053,21034,36719,6368,18562,18953,2021,3498,3,44,4,15992,5776,21319,3025.56778,-1.27617,-1.10296,70219.96843595516
Glarus,40403,413,416,-3,172,3,40590,187,0.4628369181,2019,685,GL,40590,7791,24537,8262,20546,20044,30765,9825,16950,17927,2295,3359,3,51,5,31137,0,9453,2891.24057,3.62426,3.10113,71230.36634639074
Zug,126837,1329,791,538,680,-427,127642,805,0.6346728478,2019,239,ZG,127642,25901,79665,22076,64594,63048,91475,36167,55820,56635,4980,9919,13,243,29,117143,10499,0,20308.51413,3.22294,2.34594,159105.26417636828
Freiburg,318714,3498,2099,1399,545,1147,321783,3069,0.9629322841,2019,1672,FR,321783,71380,198907,51496,161153,160630,248327,73456,148134,133187,13546,26342,21,479,62,105150,135458,81175,19459.65648,2.06306,1.9878,60474.47031073736
Solothurn,273194,2592,2311,281,1217,445,275247,2053,0.7514806328,2019,791,SO,275247,52352,168215,54680,137659,137588,212104,63143,115759,120186,14173,24580,15,443,69,166058,70477,38712,18620.63281,1.36751,1.21049,67650.62947098425
Basel-Stadt,194766,2060,2063,-3,3075,-1265,195844,1078,0.5534846945,2019,37,BS,195844,33969,123115,38760,94997,100847,124085,71759,94518,71139,10209,19115,24,752,82,195844,0,0,38316.71638,0.5419,2.88366,195649.1716876698
Basel-Landschaft,288132,2543,2481,62,831,467,289468,1336,0.4636763706,2019,518,BL,289468,55458,169810,64200,141890,147578,222615,66853,117224,131112,15749,24605,10,692,74,196919,85694,6855,20816.19197,-0.01562,-0.24267,71911.89343899844
Schaffhausen,81991,724,809,-85,314,151,82348,357,0.435413643,2019,298,SH,82348,15403,49301,17644,40768,41580,60891,21457,33798,36511,4567,7308,1,146,17,47071,26831,8446,7293.68099,1.69137,3.30408,88571.44059357847
Appenzell A.Rh.,55234,558,484,74,80,32,55445,211,0.3820110801,2019,243,AR,55445,11198,33195,11052,27938,27507,46319,9126,23639,24162,2774,4779,1,82,8,15763,26713,12969,3254.50915,1.67036,1.52575,58697.97366759852
Appenzell I.Rh.,16145,174,134,40,22,-96,16128,-17,-0.105295757,2019,172,AI,16128,3405,9566,3157,8303,7825,14312,1816,7285,7025,853,951,1,12,1,0,0,16128,1046.87968,1.23163,0.63018,64910.694444444445
St.Gallen,507697,5269,4047,1222,2877,-1468,510734,3037,0.598191441,2019,2028,SG,510734,104584,311506,94644,256039,254695,385916,124818,221464,222293,24356,41843,29,644,71,354003,67039,89692,38961.85693,2.33846,1.55903,76286.00588564693
Graubünden,198379,1630,1748,-118,965,-80,199021,642,0.3236229641,2019,7105,GR,199021,35381,120467,43173,99707,99314,161639,37382,84525,87117,10709,16403,15,221,27,64720,24666,109635,14937.00048,3.00564,2.53772,75052.383818793
Aargau,678207,7044,4997,2047,3461,2041,685845,7638,1.1262048313,2019,1404,AG,685845,138809,424024,123012,344733,341112,512350,173495,292903,305201,30525,55944,32,1077,147,374960,208262,102623,44509.24537,1.88181,1.24944,64896.94518440755
Thurgau,276472,2884,2085,799,1690,607,279547,3075,1.1122283631,2019,994,TG,279547,56613,172783,50151,140885,138662,209234,70313,118600,123946,12503,24044,12,391,48,129418,57984,92145,17358.08306,2.15498,1.94326,62093.61238002912
Tessin,353343,2494,3238,-744,60,-793,351491,-1852,-0.524136604,2019,2812,TI,351491,63125,207648,80718,171141,180350,254633,96858,148299,150508,21273,30848,41,463,56,250146,76025,25320,30990.05371,1.53652,1.27599,88167.41740186804
Waadt,799145,8607,5454,3153,3463,-978,805098,5953,0.7449211345,2019,3212,VD,805098,176324,495399,133375,395189,409909,539414,265684,379802,317927,34103,70898,63,1998,283,496862,224782,83454,58635.43105,0.43052,0.45258,72830.1785000087
Wallis,343955,3138,2898,240,670,1099,345525,1570,0.4564550595,2019,5224,VS,345525,67783,208907,68835,171254,174271,267503,78022,148368,148410,18435,29759,32,436,69,189532,83083,72910,19819.03323,2.64659,2.50735,57359.18741046234
Neuenburg,176850,1670,1585,85,761,-1092,176496,-354,-0.200169635,2019,802,NE,176496,36989,105527,33980,86495,90001,131913,44583,79300,68834,9493,18588,13,228,40,102675,52364,21457,16398.4668,1.2269,1.45723,92911.26597769921
Genf,499480,5350,3369,1981,5219,-1874,504128,4648,0.9305677905,2019,282,GE,504128,106077,315296,82755,244184,259944,302692,201436,241686,191654,20266,48630,84,1561,236,459600,44528,0,54591.22122,1.28242,1.82882,108288.41329979687
Jura,73419,709,666,43,189,-75,73584,165,0.2247374658,2019,838,JU,73584,15317,42605,15662,36400,37184,62749,10835,32081,30388,4539,6470,10,84,11,24797,14742,34045,5098.25717,1.96728,1.76597,69284.86043161557
Schweiz,8606033,85914,76195,9719,53804,0,8670300,64267,0.7467668321,2020,41285,CH,8670300,1726301,5314329,1629670,4302599,4367701,6459512,2210788,3903333,3588894,403471,751735,617,19022,2981,5459871,1892586,1317843,696619.95771,-2.82595,-2.14174,80345.54256600118
Zürich,1539275,16649,12078,4571,12887,-2091,1553423,14148,0.9191340079,2020,1729,ZH,1553423,307069,980693,265661,774299,779124,1129722,423701,732076,618478,62232,134045,81,5517,947,1200621,342561,10241,149208.52767,-3.91666,-2.22879,96051.44746150919
Bern,1039474,9943,10175,-232,3615,251,1043132,3658,0.3519087539,2020,5959,BE,1043132,198135,622565,222432,512300,530832,869681,173451,459553,434188,54891,92148,55,1922,355,548169,231971,262992,80589.16775,-2.15688,-1.94666,77256.92218242753
Luzern,413120,4311,3346,965,1843,159,416347,3227,0.7811289698,2020,1493,LU,416347,84267,256790,75290,207582,208765,337132,79215,191095,175836,18746,29842,25,693,98,218741,47404,150202,28039.73666,-0.93477,-0.70846,67347.03663050292
Uri,36703,328,327,1,224,-140,36819,116,0.3160504591,2020,1077,UR,36819,7315,21739,7765,18768,18051,32073,4746,15821,16962,1965,2025,6,35,5,22675,9870,4274,1981.76975,-0.95166,-2.07136,53824.648958418205
Schwyz,160480,1633,1361,272,595,789,162157,1677,1.0449900299,2020,908,SZ,162157,31099,101197,29861,83109,79048,126227,35930,70456,70988,7144,13244,10,276,36,98652,34560,28945,10021.33084,0.66954,0.59263,61800.174152210515
Obwalden,37930,378,344,34,123,11,38108,178,0.469285526,2020,491,OW,38108,7589,23034,7485,19268,18840,32475,5633,16708,16949,1808,2592,2,45,3,10514,0,27594,2579.31542,-1.93097,-3.28305,67684.35551590218
Nidwalden,43087,397,335,62,187,180,43520,433,1.0049434864,2020,276,NW,43520,7863,26388,9269,22298,21222,36996,6524,18745,19047,2048,3620,2,48,5,15978,5863,21679,2866.35726,-5.26217,-4.60955,65862.98851102941
Glarus,40590,382,431,-49,286,17,40851,261,0.6430155211,2020,685,GL,40851,7821,24610,8420,20625,20226,30753,10098,17182,17884,2283,3443,2,50,7,31371,0,9480,2773.97578,-4.05586,-4.23192,67904.72154904409
Zug,127642,1245,868,377,913,-165,128794,1152,0.9025242475,2020,239,ZG,128794,25990,80234,22570,65227,63567,91736,37058,56495,56900,4998,10097,13,257,31,118194,10600,0,20319.26064,0.05292,3.70551,157765.58411106106
Freiburg,321783,3381,2556,825,1156,1708,325496,3713,1.153883207,2020,1672,FR,325496,71566,201329,52601,162985,162511,250287,75209,151140,132998,13544,27196,26,515,64,105813,137812,81871,18886.4844,-2.94544,-2.86922,58023.706589328285
Solothurn,275247,2663,2646,17,1504,707,277462,2215,0.80473175,2020,791,SO,277462,52851,168974,55637,138626,138836,212535,64927,117216,120496,14082,25090,14,466,75,167217,71077,39168,18140.59636,-2.57798,-2.74633,65380.4714159056
Basel-Stadt,195844,1994,2138,-144,2625,-1716,196735,891,0.4549539429,2020,37,BS,196735,34218,123788,38729,95621,101114,124151,72584,96080,70666,9966,19112,21,791,95,196735,0,0,37705.55396,-1.59503,-0.78573,191656.5631941444
Basel-Landschaft,289468,2522,2765,-243,1179,693,290969,1501,0.5185374549,2020,518,BL,290969,55753,170100,65116,142767,148202,222404,68565,118581,130683,15809,25080,11,726,77,197713,86359,6897,20464.11973,-1.69134,-1.82221,70330.92779643192
Schaffhausen,82348,764,841,-77,472,359,83107,759,0.921698159,2020,298,SH,83107,15515,49632,17960,41162,41945,61267,21840,34219,36690,4538,7485,1,151,22,47419,27219,8469,7242.44875,-0.70242,-0.14117,87146.0737362677
Appenzell A.Rh.,55445,547,530,17,166,-306,55309,-136,-0.245288123,2020,243,AR,55309,11163,32940,11206,27883,27426,46135,9174,23560,24002,2765,4882,1,87,12,15649,26711,12949,3414.4593,4.91472,4.43907,61734.243974759986
Appenzell I.Rh.,16128,171,148,23,53,75,16293,165,1.0230654762,2020,172,AI,16293,3414,9621,3258,8361,7932,14420,1873,7396,7039,849,1001,1,5,2,0,0,16293,1042.92005,-0.37823,-0.57796,64010.31424538145
St.Gallen,510734,5345,4767,578,3400,-423,514504,3770,0.7381533244,2020,2028,SG,514504,105183,313333,95988,258108,256396,387398,127106,224463,222302,24223,42706,27,678,74,356434,67446,90624,38600.65937,-0.92705,-0.13918,75024.99372210907
Graubünden,199021,1637,1800,-163,1449,-148,200096,1075,0.5401440049,2020,7105,GR,200096,35161,120785,44150,100289,99807,161989,38107,85157,87156,10715,16788,13,234,30,65578,24325,110193,14627.09554,-2.07475,-2.97998,73100.38951303375
Aargau,685845,6980,5517,1463,3933,2769,694072,8227,1.1995421706,2020,1404,AG,694072,140443,427461,126168,348814,345258,517015,177057,298014,306795,30659,57257,33,1125,168,380756,209519,103797,44108.19224,-0.90106,-1.20579,63549.87989718646
Thurgau,279547,2882,2253,629,1868,957,282909,3362,1.2026600178,2020,994,TG,282909,57168,174019,51722,142527,140382,210840,72069,120365,124794,12618,24644,12,424,52,130904,58881,93124,17559.44806,1.16006,1.21518,62067.47774019207
Tessin,351491,2506,4067,-1561,1856,-669,350986,-505,-0.143673664,2020,2812,TI,350986,62537,207438,81011,170830,180156,254109,96877,149783,148017,21222,31365,41,482,74,249664,75773,25549,29018.15979,-6.36299,-5.77044,82676.11753745163
Waadt,805098,8455,6700,1755,7994,-699,814762,9664,1.2003507648,2020,3212,VD,814762,178201,502049,134512,400217,414545,544045,270717,390456,315488,33856,72495,74,2046,322,502562,227934,84266,56442.69189,-3.73961,-3.55993,69275.066694323
Wallis,345525,3310,3276,34,1962,1252,348503,2978,0.8618768541,2020,5224,VS,348503,67768,210723,70012,172955,175548,268980,79523,150781,147805,18447,30828,32,514,80,190528,84332,73643,19025.75615,-4.0026,-5.1642,54592.804509573805
Neuenburg,176496,1633,1804,-171,601,-955,175894,-602,-0.341084217,2020,802,NE,175894,36481,105285,34128,86184,89710,131671,44223,79901,67413,9456,18822,13,246,43,101854,52618,21422,15320.30848,-6.57475,-6.53812,87099.66502552673
Genf,504128,5159,4279,880,4717,-2649,506343,2215,0.4393725403,2020,282,GE,506343,106488,316942,82913,245320,261023,302731,203612,245681,189267,20153,49239,91,1606,291,461388,44955,0,52015.88663,-4.71749,-2.93987,102728.55876352591
Jura,73584,699,843,-144,236,34,73709,125,0.1698738856,2020,838,JU,73709,15243,42660,15806,36474,37235,62740,10969,32409,30051,4454,6689,10,83,13,24742,14796,34171,4625.73525,-9.2683,-9.55789,62756.72238125602
Schweiz,8670300,89644,71192,18452,48871,0,8738791,68491,0.7899495981,2021,41285,CH,8738791,1742898,5334574,1661319,4338203,4400588,6494610,2244181,3963699,3580260,403549,767336,636,19705,3343,5497342,1908838,1332611,743330.23111,6.70527,5.39189,85060.99197360367
Zürich,1553423,17342,11925,5417,12183,-5123,1564662,11239,0.7234990083,2021,1729,ZH,1564662,310609,984746,269307,780245,784417,1136406,428256,743633,616559,62153,135482,80,5686,1017,1208239,346094,10329,152546.65496,2.23722,0.11607,97494.95735181145
Bern,1043132,10261,9890,371,3737,182,1047473,4341,0.4161505926,2021,5959,BE,1047473,199744,621199,226530,514609,532864,871624,175849,464576,432225,54602,93639,58,1965,389,549964,233241,264268,84877.88547,5.3217,4.24939,81031.09623828012
Luzern,416347,4456,3366,1090,1954,753,420326,3979,0.9556932078,2021,1493,LU,420326,85214,258090,77022,209465,210861,339079,81247,193764,176065,18815,30803,26,720,121,220641,48133,151552,30128.2107,7.44827,5.8338,71678.19906453563
Uri,36819,419,338,81,243,-17,37047,228,0.6192454982,2021,1077,UR,37047,7366,21709,7972,18844,18203,32143,4904,15941,16965,1981,2112,6,37,5,22782,9933,4332,2075.40995,4.72508,5.97861,56020.99900126867
Schwyz,162157,1694,1374,320,581,596,163689,1532,0.9447634083,2021,908,SZ,163689,31400,101748,30541,84061,79628,126855,36834,71384,71177,7192,13603,5,284,41,99436,35041,29212,10807.12397,7.84121,6.81654,66022.29819963468
Obwalden,38108,345,302,43,200,85,38435,327,0.8580875407,2021,491,OW,38435,7612,23127,7696,19454,18981,32623,5812,16930,16937,1831,2680,1,50,4,10650,0,27785,2716.26691,5.30961,5.93511,70671.70313516326
Nidwalden,43520,377,371,6,250,110,43894,374,0.859375,2021,276,NW,43894,7860,26489,9545,22488,21406,37080,6814,18935,19078,2075,3721,2,60,4,16027,5817,22050,3159.02335,10.21038,10.06293,71969.36597257029
Glarus,40851,396,432,-36,252,99,41190,339,0.8298450466,2021,685,GL,41190,7889,24747,8554,20812,20378,30891,10299,17476,17824,2293,3530,2,56,9,31700,0,9490,2980.12862,7.43167,7.1289,72350.77980092255
Zug,128794,1371,941,430,901,-376,129787,993,0.770998649,2021,239,ZG,129787,26199,80641,22947,65741,64046,91762,38025,57234,56947,5031,10237,13,291,31,118959,10828,0,22570.24618,11.07809,8.75732,173902.2103908712
Freiburg,325496,3728,2269,1459,1213,1732,329809,4313,1.3250546858,2021,1672,FR,329809,72292,203367,54150,165058,164751,253020,76789,154328,132883,13684,28252,26,546,79,106310,137898,85601,20251.55568,7.22777,5.63772,61403.89037291281
Solothurn,277462,2798,2457,341,1406,1027,280245,2783,1.0030202334,2021,791,SO,280245,53622,169413,57210,140047,140198,213728,66517,118971,120954,14088,25620,15,489,84,168651,71932,39662,19401.618,6.95138,5.18123,69230.91580581277
Basel-Stadt,196735,2052,2018,34,1541,-2464,196036,-699,-0.355300277,2021,37,BS,196036,34337,122872,38827,95406,100630,123872,72164,96818,69509,9702,19076,21,795,110,196036,0,0,40076.44716,6.28792,6.67318,204434.1200595809
Basel-Landschaft,290969,2645,2610,35,434,1411,292817,1848,0.6351192051,2021,518,BL,292817,56267,170238,66312,143638,149179,223507,69310,120231,130332,15822,25616,11,715,88,198771,87178,6868,21596.13264,5.5317,2.18664,73753.0014992299
Schaffhausen,83107,811,832,-21,586,321,83995,888,1.0685020516,2021,298,SH,83995,15831,49828,18336,41608,42387,61688,22307,34957,36677,4509,7661,2,162,26,47770,27558,8667,8249.921,13.91066,12.92377,98219.19161854872
Appenzell A.Rh.,55309,576,505,71,48,157,55585,276,0.4990146269,2021,243,AR,55585,11313,32862,11410,27993,27592,46368,9217,23785,23954,2763,4973,1,99,10,15679,26853,13053,3579.60946,4.83679,3.68367,64398.838895385445
Appenzell I.Rh.,16293,172,142,30,34,-6,16360,67,0.4112195421,2021,172,AI,16360,3417,9616,3327,8389,7971,14479,1881,7387,7051,855,1056,1,8,2,0,0,16360,1154.73784,10.72161,9.20011,70582.99755501222
St.Gallen,514504,5440,4560,880,3272,332,519245,4741,0.9214699983,2021,2028,SG,519245,106272,314899,98074,260651,258594,389811,129434,227645,222885,24278,43581,26,714,86,359447,68123,91675,41979.43718,8.75316,8.21854,80847.07061213878
Graubünden,200096,1793,1825,-32,1405,34,201376,1280,0.6396929474,2021,7105,GR,201376,35248,121024,45104,101045,100331,162520,38856,86183,86950,10737,17216,14,239,34,66054,24667,110655,15454.91878,5.65952,4.97386,76746.57744716351
Aargau,694072,7439,5368,2071,3591,3429,703086,9014,1.2987125255,2021,1404,AG,703086,142961,430594,129531,353433,349653,521525,181561,303700,308147,30890,58936,35,1157,197,384558,212438,106090,44950.70226,1.9101,0.24874,63933.433833129944
Thurgau,282909,3020,2327,693,1550,851,285964,3055,1.0798525321,2021,994,TG,285964,58001,174636,53327,144147,141817,212475,73489,122186,125305,12763,25178,12,455,65,132006,59880,94078,19274.42113,9.76667,7.99129,67401.56498720119
Tessin,350986,2556,3118,-562,1894,-26,352181,1195,0.3404694204,2021,2812,TI,352181,62356,207470,82355,171449,180732,254310,97871,151360,146769,21284,32119,43,520,84,249994,76806,25381,33181.44533,14.34717,13.17713,94217.02286608308
Waadt,814762,8884,5713,3171,6184,-968,822968,8206,1.0071652826,2021,3212,VD,822968,179789,506501,136678,404311,418657,550447,272521,399014,313418,33901,74074,77,2076,386,506885,230723,85360,62916.58247,11.46985,10.03168,76450.82490449204
Wallis,348503,3413,2831,582,2642,1837,353209,4706,1.3503470558,2021,5224,VS,353209,68414,213030,71765,175475,177734,271208,82001,154332,147735,18537,31922,31,554,83,194781,83921,74507,20134.43243,5.82724,6.49503,57004.30178732705
Neuenburg,175894,1689,1616,73,940,-732,176166,272,0.1546385892,2021,802,NE,176166,36347,105216,34603,86394,89772,131653,44513,81073,66304,9297,19176,14,251,51,103187,51500,21479,17602.75094,14.89815,15.21069,99921.38630609766
Genf,506343,5245,3288,1957,4205,-3244,509448,3105,0.6132206824,2021,282,GE,509448,107378,317976,84094,246918,262530,302804,206644,249203,187906,20066,50158,102,1680,320,464118,45330,0,56341.88573,8.31669,7.37909,110593.98747271557
Jura,73709,722,774,-52,158,0,73798,89,0.1207450922,2021,838,JU,73798,15160,42536,16102,36522,37276,62732,11066,32653,29704,4400,6915,12,96,17,24697,14944,34157,5322.68296,15.06674,14.65695,72125.02994661102
Schweiz,8738791,82371,74425,7946,68760,0,8815385,76594,0.8764827995,2022,41285,CH,8815385,1755213,5368549,1691623,4379953,4435432,6519362,2296023,4024051,3589295,402798,780357,647,14293,3682,5547579,1932177,1335629,,,,
Zürich,1564662,15426,12071,3355,16359,-3552,1579967,15305,0.9781665305,2022,1729,ZH,1579967,312392,994624,272951,788846,791121,1141651,438316,756713,619417,61890,136723,83,3970,1124,1221626,347932,10409,,,,
Bern,1047422,9278,10302,-1024,5234,-296,1051437,4015,0.3833220994,2022,5959,BE,1051437,200509,620777,230151,516805,534632,872661,178776,469022,431354,54214,94967,57,1389,416,551861,234361,265215,,,,
Luzern,420326,4080,3534,546,2856,895,424851,4525,1.0765453481,2022,1493,LU,424851,85932,260162,78757,212021,212830,340582,84269,196755,176873,18845,31692,27,520,127,223366,48728,152757,,,,
Uri,37047,320,335,-15,251,14,37317,270,0.7288039517,2022,1077,UR,37317,7362,21811,8144,19007,18310,32224,5093,16026,17082,1973,2200,6,25,5,22995,9998,4324,,,,
Schwyz,163689,1521,1345,176,968,35,164920,1231,0.7520358729,2022,908,SZ,164920,31575,101903,31442,84722,80198,127120,37800,72025,71493,7227,13926,4,197,44,100253,35258,29409,,,,
Obwalden,38435,335,317,18,331,-69,38700,265,0.6894757383,2022,491,OW,38700,7638,23137,7925,19574,19126,32652,6048,17104,16975,1823,2767,1,25,4,10654,0,28046,,,,
Nidwalden,43894,393,382,11,396,107,44420,526,1.198341459,2022,276,NW,44420,7906,26689,9825,22783,21637,37150,7270,19240,19214,2064,3839,2,44,4,16062,6022,22336,,,,
Glarus,41190,357,373,-16,242,44,41471,281,0.6822044185,2022,685,GL,41471,7968,24758,8745,20975,20496,30918,10553,17630,17889,2258,3638,2,44,9,31943,0,9528,,,,
Zug,129787,1254,889,365,1276,-290,131164,1377,1.0609691263,2022,239,ZG,131164,26480,81164,23520,66574,64590,92130,39034,57960,57404,5085,10430,12,232,38,120275,10889,0,,,,
Freiburg,329860,3482,2473,1009,1615,1952,334465,4605,1.3960468077,2022,1672,FR,334465,73118,205729,55618,167569,166896,255175,79290,157683,133499,13755,28986,28,405,99,108282,140065,86118,,,,
Solothurn,280245,2550,2617,-67,1485,757,282408,2163,0.7718246534,2022,791,SO,282408,54189,169758,58461,141168,141240,214403,68005,120412,121474,14045,25990,13,367,83,169914,72522,39972,,,,
Basel-Stadt,196036,1789,2110,-321,2731,-1936,196786,750,0.3825827909,2022,37,BS,196786,34516,123376,38894,95937,100849,123465,73321,98160,69212,9522,19145,21,598,121,196786,0,0,,,,
Basel-Landschaft,292817,2492,2856,-364,961,1068,294417,1600,0.5464163624,2022,518,BL,294417,56709,170422,67286,144441,149976,223876,70541,121799,130051,15814,26126,13,504,104,199822,87691,6904,,,,
Schaffhausen,83995,740,842,-102,850,454,85214,1219,1.4512768617,2022,298,SH,85214,16063,50430,18721,42318,42896,62066,23148,35698,36956,4518,7887,3,121,27,48606,27907,8701,,,,
Appenzell A.Rh.,55585,493,531,-38,260,-91,55759,174,0.3130340919,2022,243,AR,55759,11365,32747,11647,28114,27645,46395,9364,24016,23935,2744,4983,1,66,14,15744,26922,13093,,,,
Appenzell I.Rh.,16360,149,175,-26,46,42,16416,56,0.3422982885,2022,172,AI,16416,3392,9674,3350,8408,8008,14510,1906,7420,7045,855,1083,1,9,3,0,0,16416,,,,
St.Gallen,519245,5198,4412,786,5298,477,525967,6722,1.2945719265,2022,2028,SG,525967,107360,318282,100325,264521,261446,392009,133958,231778,224539,24426,44592,20,470,111,364320,68936,92711,,,,
Graubünden,201376,1641,1995,-354,1693,-140,202538,1162,0.5770300334,2022,7105,GR,202538,35349,121064,46125,101760,100778,162686,39852,87011,86944,10737,17628,15,157,42,66483,24663,111392,,,,
Aargau,703086,6829,5420,1409,4150,2615,711232,8146,1.1586064863,2022,1404,AG,711232,144909,433224,133099,357753,353479,524909,186323,308288,310713,31059,60103,32,803,212,388542,222279,100411,,,,
Thurgau,285964,2850,2348,502,2541,676,289650,3686,1.2889734372,2022,994,TG,289650,58864,175890,54896,146046,143604,213633,76017,124170,126446,12894,25730,12,321,74,133452,60676,95522,,,,
Tessin,352181,2435,3537,-1102,2796,281,354023,1842,0.5230265119,2022,2812,TI,354023,62193,208340,83490,172337,181686,254597,99426,153195,146184,21357,32761,43,389,92,251844,76920,25259,,,,
Waadt,822968,8364,6218,2146,6905,-1595,830431,7463,0.9068396341,2022,3212,VD,830431,180828,510764,138839,408209,422222,554772,275659,405980,313352,33611,75333,83,1646,405,511867,232420,86144,,,,
Wallis,353209,3148,3204,-56,3078,1490,357282,4073,1.1531416244,2022,5224,VS,357282,68941,215062,73279,177835,179447,272671,84611,157310,148115,18653,32679,38,373,100,196906,85174,75202,,,,
Neuenburg,176166,1577,1680,-103,1284,-805,176571,405,0.2298968019,2022,802,NE,176571,36157,105474,34940,86657,89914,131328,45243,82116,65602,9140,19433,13,205,61,103225,51728,21618,,,,
Genf,509448,5070,3721,1349,7422,-2157,514114,4666,0.9158932806,2022,282,GE,514114,108417,320827,84870,249007,265107,303157,210957,253662,188043,19930,50674,107,1341,344,467954,46160,0,,,,
Jura,73798,600,738,-138,186,24,73865,67,0.0907883682,2022,838,JU,73865,15081,42461,16323,36566,37299,62622,11243,32878,29484,4359,7042,10,72,19,24797,14926,34142,,,,
